##################################################
#                                                #
#                                                #
#                    /                           #
#          \                                     #
#                                                #
##################################################
