#################################
#                               #
#            \               #  #
#                   ######## #  #
#                   #      # #  #
#                   #      # #  #
#    /              #      ###  #
#                   #           #
#################################
