########################################
#                                /     #
#          #############################
#          #                           #
#          #                       \   #
#          #                           #
#                                      #
########################################
