################################################################################
#                                                                              #
#                                      #                                       #
#                                      #                                       #
#                                      #                           \           #
#                                      #                                       #
#                                      #                                       #
#                                      #                                       #
#         /                            #                                       #
#                                      #                                       #
#                                      #                                       #
################################################################################
