################################################################################
#                                  #                                           #
#                                  #                                           #
#                                  #                                           #
#                                  #                               \           #
#                               #  #                                           #
#                               #  #                                           #
#                               #  #                                           #
#         /                     #                                              #
#                               #                                              #
#                               #                                              #
################################################################################
